100x100
0001010000100100001001100011100100010000111000010000000010101000010000010100110011000000010011001010
0100100100101001000100000000000001001010000001101010101010001010000010000101000000001010101000111111
1100101001110101000010110101000000100100000000100110001000000001001010000001111000100110000110000010
0100100001001001000100000001010000111000100011001010000001100000000001010001010101001101110000000010
0000001011101101100010101000100100100000100000000111000100000010101001100101000100000011111110100001
0011011010010100000111000101001001011010010010110000100110100000011110001110000000000000001010000010
0100011010100001000000010001100000101000000100111010000000000001000000010011010000010010101010101100
0110000000111010100000110110010011000000100100001000000110110000001111101010000010000010100000000100
0001000110100000111101000100010000110111110000001000000010001100000000101000101001111110100000100110
0000011100001101001001001001001000100001001101001000010001001010000000110010100100000000010100100010
0100111111000000101011101000101011110100110000000010010100110000011000000001000100110001000000100000
1010100101100000000000100000011011001000010001001100000010000101010010000000010000010100101010110000
1100000000011100100000001000011000100000010011001111001010010100000001010000101011000110000000000011
1001111010000110110000000010000010000100010100010100100100100001010011000000100000100000000000100000
1000010000100001000010011010000100010000000100000100000101001000000010100000100010010101010011100000
1000010001100000000110000101100100000011000000000100110000100000011100010001000000010000000010000010
0000000010100010100010100010000100011000010000010100100110000000100000001001000010000000000100010100
0001000100001001000010101000111001101000001101101000000101000000001101011100000000000001100001001100
0100000011001000000000000010000101001010000000011000000000000011000000101110000011101011000000100010
0000010000111001000010001010000100100000010000000000001110000000010000101101110000101010100110100000
1011000000111010001000001100000010110010000001000100000000110110000001000001001000010000000000001100
0000001101101000010000111000001110001100001001000001001000001101110000000100100000010101000000010000
0001001010000000010010100100000000000001010001011001000000010000000100010000100001010000100110000000
1010100001100000001010100000010100100000000000001000100101010000000010100001000000100100110101000001
0000000000100000001100000000010100100000000000001000000010100110000001101010001000100010010101000000
0100000000110010000100001000010110000001010000000011010010100001010010000000000000110101000000011000
1010010001010000100001000011010110001000101011000000101010110110010010001000000111000011000101110000
1001000110000011100101000100000100010001001100001110010000110000100000010001110000010101000110000001
1100000000100010000101000000001000001101011010000010011101000000001110000000000000100100100000110001
0000000101110000101001010001000010000000001010100000010000100001110111011000001000000001010010000010
0100100000000000101000000000000010001000010101100000100011101111001000010011001000101001100000000111
1110000101010000000000000001000000000001000000101001100001001100100000011010010000111000111010101010
0000010000000010011000100000010100100000110001101001000110000000000101110011110000111110000000110000
0001100000001111010000000100111001110001110000001000010100010010010010001100001101000001011100000101
0001001010100000001010000000110001000000000010010001001000011001000001111000011000011100000000110111
0110100001000010000111000000000001000111110000011001010100000101100000100010100100000010000000000100
0111000101000011000100100001010000010000001110010000000010001010110100001001001100100000000010010010
0010001011000110000001111010000101000010000001001101110100100010111010010000010010000000000010010001
0101100001011000001000100000100011100001100001101000010110001001101001010100000010010001001010000010
0011000100000000000110000100000001110000001110101010000000101100001010000100010000000100001000100010
0101110010000000010000000000110011000010110011100000100000010000000000001111100101000010010001000100
0011001100000100001101001110010001000101101000000000000100000011000001000000010001000001111000110000
0000010000000101100110101001000110000200000001000001010001000010100000000000100010000000010000100000
0010011010000010000001000000000001001000000010001001010011000010110000100000001111000000001000000000
0111101000010100100110010010011000001000101000000001001010110000000001110100000000100101001110100110
1000010000000100100000101101000011101101000000100010000011101011001101011000000000101000010001110000
0101010000100010110110000001110110010001010011010000111001000100000111000000001000001010011000010111
1000000010001101101000010101001000100010001010000000011010101000010010000010010000000000010000100111
1010000001100000110010100000100100000001000010000001011011100000010010000001110100100000001000001000
0001100000100010110000000000010010100100100010000000000010000010000100001000101001000110000000100001
0000000000100000001001010000000000000100010000111000001000000000111000100001001000000000100011101100
0001100001100100000010000001000001000010010010010000110001100011000010000100010000100100000111010000
1001000000101000000100101110010010010000001100101101100000001000110100000010110100101100001100100100
1000000001000000000000110000000000001100000010010000001110100010101000010000011000000001001110101101
0000000000001000110011100011000000000010011010101011011000010000010011110111100000100001100000100100
0000100100010000001000100101001101000010000000100010110100100000000011001001101110000000010010000001
1000000010011010000000001001000110010100000100110001010000000001010011001101000000000011000000000000
0000100000000010001101110000000001000011100010010000010010011000000001001001001000000000000000001011
0111000000010000000101010000000001010000101100100010010111101000011010100100000000001010000010000010
0011001000110000000001000000100001010010000001001101001001100100000010100000001010011001000100000010
0010011000001100001010011000000010100110011000000100000000000101000010000100000010001000010010011010
0001010101000010011010000001010010000000100000010000101000010010100101000100000000000100001000101100
0010000010000011001000000000000000010000010000100100000011000010100001001001110101101100010001001000
0010000000010011100010001000000000011000011000000011001000000000011001010000000100000000000100110000
0110000000100010010110001000110110001001011100010000010000100110010000111101010000100100000000000000
0100010100000000010100001011100000001001011000000000010001100101001010101100111110000010100011010110
0100011000110000010000010110001000001000010011000101010001011000101000000111011000000000110011010001
0011000000000001011010110100010111000000000000010100001111000100100000000000100000001000111000010001
0000110000100100000000000100100100001101001110100100100001000011101000111000001001000001111010001000
0101101000010101100001000111010000100000111001000000000001001010000000100000001101101010111000000000
0011100100000011000000001001001011100001000001110011000100001100010100000000101011001010101000100100
0101010010100000001000100001001001000011010100001100001000010000000100011010011000110011000101010100
0000010110101010000101110100001100010001010000100110000000001001011000000000001101001110000011010001
0001001001000000000011101001000000011110000001000000010010000000101000000000100000010000110100110000
1100000000110001010010010000000001100100110101100001110000011001000110000010001110011110110000000000
0100000000000010001000000000101000100001011000000000110101101001001010101111010100000010000100000110
1111010100001000011001000001011010001000010110010001011000000001001010010100010100100100000000000100
0010101001100110010010001010000000100100010111111010000001100001000000001010010000011000100100000101
0000101010010001100110101000000000000100001100010101100100100100000101011000010000001000000011110010
0000100111000000100010110000010000100001010010000100010000000011011010001000100000000111000001011001
1011000000011100011001010011011100100100000100010010100000101001010001100010101011011100001100011110
1110000101010101000000000011000001011000010100001000010100001000000010011100100000100000100000100000
0100000100001001001000100000010000110110010000101100000010110100001010000000100000000001101100000110
0100010100010100001100110011100101010110100000000000100001000100000000110101101000100011000110001000
0010000100010001100010100100110010000101100000000000000000100000010000000001110000000101010000000000
1001110000100010100011110001110001100010100000010000010001111001010000001010011000101010000001110000
0110100000000100000110000000000000010101001001100100000000001001000001000100100000101010000000001000
0001000000010111110001011100001100111100000000000100101101010000000000101001101110001000110000110001
1010000000111010001001000100001110100101000001001001001010000010001001011000100000010100100101000010
1000000010000101000000110100001110010010111010110000000001101010000100000101010100011110000000010100
1001100000100000010010001010001100000000000000000000100001101000100000010110000000100000100010001010
0000000011101000000000010000000110000000000100000000001110001000010010100001000010010010010100100000
1111100000010010001001000000101100010000000101001011001000010100111000010010110100100001101000011000
0000000000010000011011000001011000101001000010110011101011010101000110000001000011010011110100010001
1000000010011100000000000101100000000000000001000000001101000010010100010000110101100001101000100100
1010010110010001000110000010000011001001010011100000110100100111100000110011001010000001101100110100
0100000100100101000110100111101110010100000001001000000000100010111011000111000001001000101001010000
0000000001000000001101001100001110000110010101011001001100100001110100101100000001101001100011000001
0011111000000010000001111110101000111000000110101000011101010000000010001001010010010001100001001011
1001100011000100000101000000011000101010000000110110010000111000000001000000000000111001000001100000