3x6
000
1e1
000
000
020
000

e:
20x10
     \__    __/     
     /_/ /\ \_\     
    __ \ \/ / __    
    \_\_\/\/_/_/    
__/\___\_\/_/___/\__
  \/ __/_/\_\__ \/  
    /_/ /\/\ \_\    
     __/ /\ \__     
     \_\ \/ /_/     
     /        \     
e_data:
spritemode
end_data

f:
2x2
12
34