25x25
0001000000100000000001100
0011000000100001100000100
0000000000100001000001000
0110000000000010000001000
0100100100000000000100000
0000000000010100000011000
0010101000100000001000000
0000000001010000000101111
1100101001010101000000110
1010000001000000000001001
1000000000000100000000000
1111000100010000010000000
0000000001002000000000000
0010100001110001000110010
0000000000000000000001000
1000101001001100000000010
0000001010100000000010100
0000001001000001000000000
1000010000001010100010010
0000100000000000010000000
0011001010000000000011000
1010010000110100000101100
0000010000000000111000000
0000000000000001010000000
0100000000100001000000010